E E E E E E SY P E E E E E E E
E S P P P P P P E E E E E E E
E E E E E E P E E E E E E E E
E E E E E E P E E E E E E E E
E E E E E E P E E E E E E E E
E E E E E E GY E E E E E E E
SG P P P P P P P E E E E E SB
E E E E E E GR E E E E E E E
E E E E E E P E E E E E E E E
E E E E E E P E E E E E E E E
E E E E E E P E E E E E E E E
E E E E E E GG E E E E E E E
E E E E E E P E E E E E E E E
E S P P P P P P E E E E E E SR
E E E E E E E E E E E E E E E